date,Date,Molecular Total,Tests,Positives,Molecular Missing,Serology Total,Serology New,Serology Positive New,First Molecular Test per person,Repeat Molecular Tests,All Molecular Tests,All Positive Molecular Tests,Antigen Positive New,Antigen New,Antigen Total,Negatives,Odds
2020-03-10,2020-03-10,437,104,14,,1,0,0,103,6,109,14,0,0,0,90,0.15555555555555556
2020-03-11,2020-03-11,608,171,22,,1,0,0,176,6,182,23,0,0,0,149,0.1476510067114094
2020-03-12,2020-03-12,1023,415,29,,1,0,0,424,7,431,29,0,0,0,386,0.07512953367875648
2020-03-13,2020-03-13,1959,936,61,,1,0,0,970,14,984,64,0,0,0,875,0.06971428571428571
2020-03-14,2020-03-14,2853,894,73,,1,0,0,920,15,935,74,0,0,0,821,0.08891595615103533
2020-03-15,2020-03-15,3874,1021,68,,1,0,0,1058,27,1085,72,0,0,0,953,0.07135362014690451
2020-03-16,2020-03-16,6003,2129,150,,1,0,0,2218,18,2236,152,0,0,0,1979,0.07579585649317837
2020-03-17,2020-03-17,8668,2665,249,,1,0,0,2760,28,2788,255,0,0,0,2416,0.10306291390728477
2020-03-18,2020-03-18,11628,2960,259,,1,0,0,3071,156,3227,263,0,0,0,2701,0.0958904109589041
2020-03-19,2020-03-19,14512,2884,278,,1,0,0,2995,142,3137,286,0,0,0,2606,0.10667689946277821
2020-03-20,2020-03-20,18137,3625,388,,1,0,0,3755,124,3879,394,0,0,0,3237,0.11986407167130059
2020-03-21,2020-03-21,20659,2522,322,,1,0,0,2604,168,2772,340,0,0,0,2200,0.14636363636363636
2020-03-22,2020-03-22,22542,1883,286,,1,0,0,1941,160,2101,298,0,0,0,1597,0.17908578584846588
2020-03-23,2020-03-23,26298,3756,609,,1,0,0,3894,202,4096,632,0,0,0,3147,0.19351763584366063
2020-03-24,2020-03-24,30260,3962,718,,1,0,0,4111,208,4319,738,0,0,0,3244,0.22133168927250307
2020-03-25,2020-03-25,34329,4069,746,,1,0,0,4212,269,4481,792,0,0,0,3323,0.22449593740595847
2020-03-26,2020-03-26,38712,4383,935,,1,0,0,4540,299,4839,984,0,0,0,3448,0.2711716937354988
2020-03-27,2020-03-27,43046,4334,943,,1,0,0,4470,344,4814,1007,0,0,0,3391,0.2780890592745503
2020-03-28,2020-03-28,45827,2781,654,,1,0,0,2868,332,3200,704,0,0,0,2127,0.307475317348378
2020-03-29,2020-03-29,47885,2058,523,,1,0,0,2155,318,2473,576,0,0,0,1535,0.34071661237785017
2020-03-30,2020-03-30,52892,5007,1238,,1,0,0,5164,416,5580,1317,0,0,0,3769,0.3284690899442823
2020-03-31,2020-03-31,58107,5215,1266,,1,0,0,5460,471,5931,1403,0,0,0,3949,0.32058749050392504
2020-04-01,2020-04-01,63001,4894,1338,,1,0,0,5114,465,5579,1425,0,0,0,3556,0.3762654668166479
2020-04-02,2020-04-02,68172,5171,1277,,4,3,1,5408,596,6004,1403,0,0,0,3894,0.32794042116076016
2020-04-03,2020-04-03,73873,5701,1480,,4,0,0,5939,629,6568,1625,0,0,0,4221,0.3506278133143805
2020-04-04,2020-04-04,77830,3957,1162,,8,4,1,4054,690,4744,1322,0,0,0,2795,0.41574239713774597
2020-04-05,2020-04-05,81221,3391,977,,8,0,0,3565,540,4105,1078,0,0,0,2414,0.40472245236122617
2020-04-06,2020-04-06,87794,6573,1930,,12,4,0,6798,783,7581,2100,0,0,0,4643,0.41567951755330607
2020-04-07,2020-04-07,94298,6504,2022,,16,4,0,6655,967,7622,2241,0,0,0,4482,0.45113788487282463
2020-04-08,2020-04-08,101027,6729,1864,,18,2,0,6972,983,7955,2107,0,0,0,4865,0.3831449126413155
2020-04-09,2020-04-09,107374,6347,1978,,40,22,2,6728,1042,7770,2276,0,0,0,4369,0.45273517967498283
2020-04-10,2020-04-10,114880,7506,2055,,41,1,1,7784,1063,8847,2315,0,0,0,5451,0.37699504678040724
2020-04-11,2020-04-11,119298,4418,1329,,42,1,0,4591,817,5408,1506,0,0,0,3089,0.4302363224344448
2020-04-12,2020-04-12,122255,2957,930,,45,3,2,3055,720,3775,1073,0,0,0,2027,0.45880611741489885
2020-04-13,2020-04-13,128338,6083,1986,,53,8,0,6212,1148,7360,2231,0,0,0,4097,0.48474493531852575
2020-04-14,2020-04-14,138174,9836,2927,,61,8,2,10031,1510,11541,3271,0,0,0,6909,0.4236503111883051
2020-04-15,2020-04-15,147801,9627,2541,,71,10,2,9983,1472,11455,2854,0,0,0,7086,0.3585944115156647
2020-04-16,2020-04-16,156594,8793,2386,,92,21,0,8946,1756,10702,2797,0,0,0,6407,0.37240518183237087
2020-04-17,2020-04-17,167435,10841,2990,,171,79,5,11275,1851,13126,3323,0,0,0,7851,0.380843204687301
2020-04-18,2020-04-18,173375,5940,1481,,179,8,3,6305,1173,7478,1708,1,1,1,4459,0.33213725050459747
2020-04-19,2020-04-19,177922,4547,1089,,189,10,1,4659,945,5604,1267,0,0,1,3458,0.3149219201850781
2020-04-20,2020-04-20,188532,10610,2686,,252,63,6,10994,1978,12972,3109,0,0,1,7924,0.33897021706208985
2020-04-21,2020-04-21,197865,9333,2187,,327,75,11,9642,2183,11825,2711,0,0,1,7146,0.3060453400503778
2020-04-22,2020-04-22,210148,12283,2706,,473,146,17,12641,2758,15399,3230,0,0,1,9577,0.2825519473739167
2020-04-23,2020-04-23,220820,10672,2406,,945,472,30,10841,2587,13428,2933,0,0,1,8266,0.2910718606339221
2020-04-24,2020-04-24,233053,12233,2277,,1843,898,82,12344,2557,14901,2816,0,0,1,9956,0.22870630775411813
2020-04-25,2020-04-25,241151,8098,1494,,2330,487,25,8400,1867,10267,1830,0,0,1,6604,0.2262265293761357
2020-04-26,2020-04-26,245979,4828,845,,2785,455,36,4774,1433,6207,1166,0,0,1,3983,0.21215164448907858
2020-04-27,2020-04-27,256827,10848,2129,,3925,1140,79,10819,2976,13795,2770,0,0,1,8719,0.24417937836907902
2020-04-28,2020-04-28,268946,12119,2104,,5344,1419,83,12233,3045,15278,2767,0,0,1,10015,0.21008487269096354
2020-04-29,2020-04-29,281435,12489,2187,,7047,1703,105,12556,2959,15515,2825,0,0,1,10302,0.21228887594641818
2020-04-30,2020-04-30,295053,13618,2047,,8421,1374,116,13710,3184,16894,2705,0,0,1,11571,0.1769077867081497
2020-05-01,2020-05-01,308979,13926,2083,,10195,1774,130,13960,3336,17296,2732,0,0,1,11843,0.17588448872751836
2020-05-02,2020-05-02,316153,7174,1029,,10790,595,57,7291,1914,9205,1412,0,0,1,6145,0.16745321399511798
2020-05-03,2020-05-03,321202,5049,734,,11194,404,42,5033,1439,6472,1001,0,1,2,4315,0.17010428736964078
2020-05-04,2020-05-04,333048,11846,1879,,13211,2017,162,11811,3634,15445,2710,0,0,2,9967,0.18852212300591953
2020-05-05,2020-05-05,345470,12422,1736,,15186,1975,157,12353,3675,16028,2507,0,1,3,10686,0.16245554931686318
2020-05-06,2020-05-06,358614,13144,1699,,17162,1976,183,13041,3655,16696,2484,0,0,3,11445,0.14844910441240716
2020-05-07,2020-05-07,371936,13322,1679,,19229,2067,173,13397,3730,17127,2469,0,0,3,11643,0.1442068195482264
2020-05-08,2020-05-08,385063,13127,1454,,21113,1884,136,13180,3778,16958,2224,0,0,3,11673,0.12456095262571747
2020-05-09,2020-05-09,390846,5783,684,,21740,627,38,5716,2000,7716,1025,0,0,3,5099,0.13414394979407726
2020-05-10,2020-05-10,393972,3126,385,,22094,354,77,3069,1492,4561,674,0,0,3,2741,0.14045968624589567
2020-05-11,2020-05-11,405629,11657,1306,,23931,1837,161,11577,4072,15649,2124,0,0,3,10351,0.12617138440730363
2020-05-12,2020-05-12,418775,13146,1450,,25800,1869,148,13039,4333,17372,2271,0,0,3,11696,0.12397400820793433
2020-05-13,2020-05-13,432612,13837,1314,,27618,1818,178,13732,4195,17927,2112,1,1,4,12523,0.10492693444062924
2020-05-14,2020-05-14,445855,13243,1314,,29295,1677,164,13141,4243,17384,2084,0,0,4,11929,0.11015173107553022
2020-05-15,2020-05-15,459550,13695,1104,,30908,1613,141,13586,4239,17825,1852,0,0,4,12591,0.0876816773886109
2020-05-16,2020-05-16,466592,7042,645,,31442,534,50,6956,2389,9345,1033,1,1,5,6397,0.10082851336564014
2020-05-17,2020-05-17,470860,4268,363,115.0,31800,358,54,4227,1636,5863,598,3,3,8,3905,0.09295774647887324
2020-05-18,2020-05-18,484145,13285,1315,1.0,33428,1628,137,13142,4471,17613,2144,1,1,9,11970,0.1098579782790309
2020-05-19,2020-05-19,496369,12224,1073,0.0,35133,1705,164,12168,4526,16694,1860,16,82,91,11151,0.0962245538516725
2020-05-20,2020-05-20,509111,12742,1011,0.0,36993,1860,149,12584,4337,16921,1678,12,100,191,11731,0.08618191117551786
2020-05-21,2020-05-21,520718,11607,966,0.0,38697,1704,193,11521,4437,15958,1670,19,281,472,10641,0.09078094164082323
2020-05-22,2020-05-22,531664,10946,864,0.0,40340,1643,158,10839,3974,14813,1504,10,213,685,10082,0.08569728228526086
2020-05-23,2020-05-23,536586,4922,388,0.0,40761,421,41,4892,1823,6715,628,16,196,881,4534,0.08557565063961182
2020-05-24,2020-05-24,540657,4071,302,0.0,41074,313,40,4022,1543,5565,509,15,204,1085,3769,0.08012735473600424
2020-05-25,2020-05-25,543742,3085,198,0.0,41403,329,49,3075,1492,4567,382,20,234,1319,2887,0.0685833044683062
2020-05-26,2020-05-26,554874,11132,864,0.0,42925,1522,130,11053,4389,15442,1542,20,303,1622,10268,0.08414491624464356
2020-05-27,2020-05-27,565012,10138,687,0.0,44381,1456,153,10056,3909,13965,1224,12,233,1855,9451,0.07269072055867104
2020-05-28,2020-05-28,574318,9306,640,0.0,45682,1301,177,9241,3623,12864,1164,8,231,2086,8666,0.07385183475651973
2020-05-29,2020-05-29,584555,10237,530,0.0,47004,1322,138,10172,3582,13754,1022,15,216,2302,9707,0.054599773359431336
2020-05-30,2020-05-30,590312,5757,271,0.0,47271,267,35,5753,1836,7589,465,10,172,2474,5486,0.04939846882974845
2020-05-31,2020-05-31,593995,3683,161,0.0,47460,189,38,3657,1412,5069,298,6,142,2616,3522,0.04571266325951164
2020-06-01,2020-06-01,603443,9448,508,0.0,48610,1150,165,9398,3543,12941,936,6,224,2840,8940,0.056823266219239374
2020-06-02,2020-06-02,612902,9459,446,0.0,49712,1102,88,9419,3774,13193,881,9,221,3061,9013,0.04948407855320093
2020-06-03,2020-06-03,622480,9578,461,0.0,50874,1162,123,9485,3757,13242,870,3,192,3253,9117,0.05056487879785017
2020-06-04,2020-06-04,631137,8657,379,0.0,51943,1069,90,8600,3615,12215,750,2,171,3424,8278,0.04578400579850205
2020-06-05,2020-06-05,639731,8594,338,0.0,53152,1209,150,8562,3163,11725,660,4,185,3609,8256,0.04093992248062016
2020-06-06,2020-06-06,644336,4605,149,0.0,53440,288,33,4617,1757,6374,288,3,149,3758,4456,0.03343806104129264
2020-06-07,2020-06-07,647939,3603,151,0.0,53612,172,24,3580,1510,5090,252,10,141,3899,3452,0.04374275782155272
2020-06-08,2020-06-08,658782,10843,355,0.0,54623,1011,102,10829,3437,14266,678,6,189,4088,10488,0.033848207475209766
2020-06-09,2020-06-09,669906,11124,345,0.0,55788,1165,109,11078,3570,14648,644,10,188,4276,10779,0.0320066796548845
2020-06-10,2020-06-10,680246,10340,259,0.0,56987,1199,137,10353,3327,13680,562,12,242,4518,10081,0.025691895645273286
2020-06-11,2020-06-11,690687,10441,226,0.0,58220,1233,107,10428,2971,13399,505,11,270,4788,10215,0.02212432697014195
2020-06-12,2020-06-12,701006,10319,255,0.0,59460,1240,85,10307,3157,13464,484,9,267,5055,10064,0.02533783783783784
2020-06-13,2020-06-13,705914,4908,97,0.0,59690,230,22,4921,1731,6652,193,7,205,5260,4811,0.02016212845562253
2020-06-14,2020-06-14,709716,3802,77,0.0,59866,176,25,3801,1435,5236,146,6,212,5472,3725,0.020671140939597314
2020-06-15,2020-06-15,720647,10931,235,0.0,61042,1176,114,10933,3609,14542,492,9,461,5933,10696,0.021970830216903516
2020-06-16,2020-06-16,731232,10585,198,0.0,62250,1208,88,10605,3485,14090,391,13,433,6366,10387,0.019062289400211804
2020-06-17,2020-06-17,745969,14737,249,0.0,63477,1227,115,14785,3544,18329,449,23,464,6830,14488,0.017186637217007177
2020-06-18,2020-06-18,760900,14931,241,0.0,64848,1371,90,14956,3374,18330,407,9,402,7232,14690,0.01640571817562968
2020-06-19,2020-06-19,770127,9227,175,0.0,65972,1124,82,9250,2944,12194,313,9,494,7726,9052,0.019332744144940343
2020-06-20,2020-06-20,775619,5492,93,0.0,66242,270,17,5504,1934,7438,162,5,453,8179,5399,0.017225412113354325
2020-06-21,2020-06-21,779602,3983,79,0.0,66387,145,16,3994,1438,5432,120,6,321,8500,3904,0.02023565573770492
2020-06-22,2020-06-22,789931,10329,225,0.0,67492,1105,98,10333,3728,14061,415,8,744,9244,10104,0.022268408551068885
2020-06-23,2020-06-23,800715,10784,189,0.0,68784,1292,129,10811,3776,14587,332,4,644,9888,10595,0.017838603114676735
2020-06-24,2020-06-24,811413,10698,211,0.0,70102,1318,100,10725,3497,14222,344,13,659,10547,10487,0.020120148755602175
2020-06-25,2020-06-25,821088,9675,206,0.0,71302,1200,108,9692,3252,12944,335,9,538,11085,9469,0.021755201182807056
2020-06-26,2020-06-26,831615,10527,198,0.0,72557,1255,106,10583,3230,13813,329,8,764,11849,10329,0.019169329073482427
2020-06-27,2020-06-27,837683,6068,134,0.0,72800,243,19,6073,1852,7925,192,4,663,12512,5934,0.022581732389619143
2020-06-28,2020-06-28,842445,4762,71,0.0,73021,221,19,4787,1656,6443,122,4,573,13085,4691,0.015135365593690045
2020-06-29,2020-06-29,854804,12359,204,0.0,74152,1131,100,12413,4136,16549,318,11,923,14008,12155,0.016783216783216783
2020-06-30,2020-06-30,867361,12557,221,0.0,75383,1231,111,12559,3955,16514,346,9,1067,15075,12336,0.01791504539559014
2020-07-01,2020-07-01,878496,11135,218,0.0,76482,1099,103,11177,3799,14976,319,12,1026,16101,10917,0.019968855912796554
2020-07-02,2020-07-02,889030,10534,225,0.0,77599,1117,120,10588,3827,14415,344,15,1011,17112,10309,0.021825589290910854
2020-07-03,2020-07-03,895328,6298,98,0.0,78021,422,61,6327,2453,8780,163,11,1145,18257,6200,0.015806451612903227
2020-07-04,2020-07-04,898462,3134,60,0.0,78138,117,9,3147,1417,4564,107,14,519,18776,3074,0.01951854261548471
2020-07-05,2020-07-05,903472,5010,101,0.0,78258,120,23,5016,1996,7012,136,20,666,19442,4909,0.02057445508250153
2020-07-06,2020-07-06,916398,12926,239,0.0,79177,919,94,12961,4751,17712,350,20,1097,20539,12687,0.018838180815007488
2020-07-07,2020-07-07,931657,15259,242,0.0,80262,1085,117,15292,5168,20460,327,21,1122,21661,15017,0.01611506958780049
2020-07-08,2020-07-08,946237,14580,214,0.0,81209,947,89,14624,5472,20096,300,21,1280,22941,14366,0.014896282890157316
2020-07-09,2020-07-09,959327,13090,255,0.0,82181,972,116,13107,5192,18299,356,19,1206,24147,12835,0.019867549668874173
2020-07-10,2020-07-10,972951,13624,228,0.0,83332,1151,144,13669,5341,19010,330,9,1265,25412,13396,0.01702000597193192
2020-07-11,2020-07-11,980749,7798,117,0.0,83619,287,34,7825,2838,10663,153,20,1157,26569,7681,0.015232391615675042
2020-07-12,2020-07-12,986111,5362,88,0.0,83808,189,32,5368,2046,7414,108,36,941,27510,5274,0.016685627607129314
2020-07-13,2020-07-13,1001403,15292,267,0.0,84866,1058,116,15322,5695,21017,378,4,467,27977,15025,0.017770382695507486
2020-07-14,2020-07-14,1017161,15758,232,0.0,85852,986,92,15809,6200,22009,314,25,1387,29364,15526,0.014942676800206106
2020-07-15,2020-07-15,1033363,16202,298,0.0,86785,933,104,16259,6100,22359,381,5,474,29838,15904,0.018737424547283704
2020-07-16,2020-07-16,1047208,13845,244,0.0,87718,933,108,13855,5465,19320,323,33,1480,31318,13601,0.01793985736342916
2020-07-17,2020-07-17,1060846,13638,227,0.0,88696,978,142,13657,5489,19146,302,5,442,31760,13411,0.01692640369845649
2020-07-18,2020-07-18,1069216,8370,128,0.0,88981,285,62,8378,2989,11367,169,24,1139,32899,8242,0.015530211113807329
2020-07-19,2020-07-19,1075003,5787,74,0.0,89101,120,24,5816,2145,7961,111,18,903,33802,5713,0.012952914405741292
2020-07-20,2020-07-20,1088580,13577,279,0.0,90091,990,101,13578,5012,18590,357,34,1370,35172,13298,0.020980598586253573
2020-07-21,2020-07-21,1103006,14426,256,0.0,91129,1038,115,14481,5531,20012,338,36,1464,36636,14170,0.01806633733239238
2020-07-22,2020-07-22,1116463,13457,258,0.0,92166,1037,119,13495,5314,18809,328,51,1675,38311,13199,0.01954693537389196
2020-07-23,2020-07-23,1130818,14355,259,0.0,93088,922,147,14366,6575,20941,348,28,1615,39926,14096,0.01837400681044268
2020-07-24,2020-07-24,1143936,13118,258,0.0,93874,786,110,13148,5266,18414,332,32,1551,41477,12860,0.02006220839813375
2020-07-25,2020-07-25,1152393,8457,160,0.0,94009,135,6,8481,3438,11919,200,49,1341,42818,8297,0.019284078582620223
2020-07-26,2020-07-26,1157763,5370,101,0.0,94103,94,7,5376,2280,7656,126,29,1099,43917,5269,0.01916872271778326
2020-07-27,2020-07-27,1174139,16376,361,0.0,95065,962,146,16334,6373,22707,433,38,1476,45393,16015,0.02254136746799875
2020-07-28,2020-07-28,1192618,18479,320,0.0,95949,884,118,18508,8227,26735,398,41,1565,46958,18159,0.017622115755272866
2020-07-29,2020-07-29,1208968,16350,319,0.0,96837,888,128,16366,7101,23467,388,22,1678,48636,16031,0.01989894579252698
2020-07-30,2020-07-30,1225442,16474,337,0.0,97666,829,99,16465,7411,23876,420,41,1566,50202,16137,0.02088368346037058
2020-07-31,2020-07-31,1240833,15391,319,0.0,98389,723,113,15422,6805,22227,394,6,478,50680,15072,0.021165074309978767
2020-08-01,2020-08-01,1248998,8165,147,0.0,98580,191,35,8180,3249,11429,189,11,423,51103,8018,0.01833374906460464
2020-08-02,2020-08-02,1254938,5940,110,0.0,98726,146,43,5944,2489,8433,135,27,1351,52454,5830,0.018867924528301886
2020-08-03,2020-08-03,1274314,19376,359,0.0,99501,775,101,19402,8246,27648,424,18,1833,54287,19017,0.0188778461376663
2020-08-04,2020-08-04,1291605,17291,308,0.0,100389,888,123,17326,8295,25621,395,20,1737,56024,16983,0.018135782841665195
2020-08-05,2020-08-05,1309715,18110,332,0.0,101092,703,89,18163,8193,26356,412,36,1951,57975,17778,0.018674766565417934
2020-08-06,2020-08-06,1326367,16652,354,0.0,101794,702,83,16677,7662,24339,445,26,1816,59791,16298,0.021720456497729784
2020-08-07,2020-08-07,1343032,16665,300,0.0,102508,714,94,16686,6949,23635,362,17,1914,61705,16365,0.01833180568285976
2020-08-08,2020-08-08,1352789,9757,168,0.0,102621,113,9,9775,3740,13515,219,19,1532,63237,9589,0.017520075086036084
2020-08-09,2020-08-09,1359305,6516,85,0.0,102687,66,5,6523,2961,9484,106,13,1272,64509,6431,0.01321722904680454
2020-08-10,2020-08-10,1380366,21061,373,0.0,103460,773,102,21079,9758,30837,467,32,1922,66431,20688,0.018029775715390564
2020-08-11,2020-08-11,1399588,19222,284,0.0,104243,783,109,19268,9875,29143,355,9,733,67164,18938,0.014996303727954378
2020-08-12,2020-08-12,1419244,19656,305,0.0,104982,739,114,19697,9523,29220,391,23,1849,69013,19351,0.015761459356105626
2020-08-13,2020-08-13,1438333,19089,349,0.0,105759,777,77,19155,8955,28110,444,23,1797,70810,18740,0.01862326574172892
2020-08-14,2020-08-14,1457783,19450,342,0.0,106470,711,86,19505,8441,27946,415,27,1797,72607,19108,0.017898262507850114
2020-08-15,2020-08-15,1468281,10498,151,0.0,106596,126,13,10528,3967,14495,186,5,462,73069,10347,0.014593602010244516
2020-08-16,2020-08-16,1476516,8235,120,0.0,106684,88,5,8267,3340,11607,143,20,1532,74601,8115,0.014787430683918669
2020-08-17,2020-08-17,1503835,27319,369,0.0,107384,700,108,27450,13255,40705,475,25,1999,76600,26950,0.013692022263450836
2020-08-18,2020-08-18,1529279,25444,382,0.0,108016,632,68,25576,13940,39516,455,5,670,77270,25062,0.015242199345622855
2020-08-19,2020-08-19,1553743,24464,338,0.0,108681,665,48,24494,14131,38625,407,29,1948,79218,24126,0.0140097819779491
2020-08-20,2020-08-20,1577264,23521,356,0.0,109340,659,73,23561,15250,38811,430,26,1812,81030,23165,0.015368012087200518
2020-08-21,2020-08-21,1598286,21022,283,0.0,109903,563,62,21108,14194,35302,370,23,1706,82736,20739,0.01364578812864651
2020-08-22,2020-08-22,1611344,13058,149,0.0,109989,86,11,13076,7495,20571,193,24,1246,83982,12909,0.011542334805174685
2020-08-23,2020-08-23,1621591,10247,93,0.0,110048,59,4,10267,7384,17651,117,21,1102,85084,10154,0.009158952137088831
2020-08-24,2020-08-24,1648367,26776,396,0.0,110772,724,29,26819,26399,53218,493,24,1723,86807,26380,0.015011372251705837
2020-08-25,2020-08-25,1673594,25227,381,0.0,111406,634,20,25286,27035,52321,474,33,1450,88257,24846,0.015334460275295822
2020-08-26,2020-08-26,1698924,25330,379,0.0,111918,512,19,25466,24010,49476,471,36,1454,89711,24951,0.015189771953027936
2020-08-27,2020-08-27,1719558,20634,345,0.0,112652,734,12,20677,26885,47562,420,6,424,90135,20289,0.017004288037853022
2020-08-28,2020-08-28,1743205,23647,367,0.0,113103,451,12,23667,24541,48208,460,33,1344,91479,23280,0.015764604810996563
2020-08-29,2020-08-29,1760228,17023,172,0.0,113197,94,1,17091,10829,27920,225,27,1113,92592,16851,0.010207109370363777
2020-08-30,2020-08-30,1772996,12768,140,0.0,113241,44,2,12798,11941,24739,168,21,1012,93604,12628,0.011086474501108648
2020-08-31,2020-08-31,1799030,26034,437,0.0,113650,409,18,26020,38262,64282,551,5,492,94096,25597,0.017072313161698636
2020-09-01,2020-09-01,1823824,24794,395,0.0,114058,408,14,24779,37652,62431,473,24,1306,95402,24399,0.016189188081478748
2020-09-02,2020-09-02,1845067,21243,384,0.0,114452,394,18,21232,35454,56686,470,23,1534,96936,20859,0.018409319718107293
2020-09-03,2020-09-03,1866494,21427,464,0.0,114839,387,17,21406,41139,62545,554,35,1506,98442,20963,0.022134236511949627
2020-09-04,2020-09-04,1884562,18068,349,0.0,115278,439,25,18061,33436,51497,456,26,1563,100005,17719,0.019696371127038773
2020-09-05,2020-09-05,1894151,9589,198,0.0,115348,70,3,9571,14562,24133,253,24,1221,101226,9391,0.02108401661164945
2020-09-06,2020-09-06,1901374,7223,113,0.0,115401,53,4,7228,15627,22855,139,28,1072,102298,7110,0.015893108298171588
2020-09-07,2020-09-07,1909677,8303,161,0.0,115449,48,2,8284,28329,36613,200,33,1129,103427,8142,0.01977401129943503
2020-09-08,2020-09-08,1932195,22518,546,0.0,115814,365,14,22430,54360,76790,659,15,629,104056,21972,0.02484980884762425
2020-09-09,2020-09-09,1952159,19964,475,0.0,116177,363,9,19924,47828,67752,593,36,1499,105555,19489,0.02437272307455488
2020-09-10,2020-09-10,1968742,16583,407,0.0,116526,349,18,16531,47730,64261,510,29,1388,106943,16176,0.025160731948565777
2020-09-11,2020-09-11,1985298,16556,409,0.0,116920,394,13,16506,41739,58245,506,31,1410,108353,16147,0.025329782622158913
2020-09-12,2020-09-12,1995767,10469,190,0.0,116994,74,4,10431,12898,23329,238,21,1129,109482,10279,0.018484288354898338
2020-09-13,2020-09-13,2004582,8815,161,0.0,117033,39,0,8802,14899,23701,198,31,1063,110545,8654,0.01860411370464525
2020-09-14,2020-09-14,2025653,21071,502,0.0,117370,337,10,21017,55865,76882,622,24,1508,112053,20569,0.02440565900140989
2020-09-15,2020-09-15,2045138,19485,421,0.0,117683,313,8,19443,51129,70572,520,27,1532,113585,19064,0.022083508182962654
2020-09-16,2020-09-16,2062599,17461,414,0.0,118045,362,12,17387,47253,64640,522,32,1480,115065,17047,0.024285798087640052
2020-09-17,2020-09-17,2078025,15426,353,0.0,118346,301,16,15376,51641,67017,457,46,1542,116607,15073,0.023419359118954423
2020-09-18,2020-09-18,2093391,15366,435,0.0,118658,312,13,15290,43203,58493,543,38,1511,118118,14931,0.02913401647578863
2020-09-19,2020-09-19,2101839,8448,200,0.0,118733,75,3,8405,14648,23053,252,33,1204,119322,8248,0.02424830261881668
2020-09-20,2020-09-20,2108059,6220,142,0.0,118761,28,2,6190,16685,22875,176,29,1158,120480,6078,0.023362948338269168
2020-09-21,2020-09-21,2126601,18542,427,0.0,119047,286,17,18457,60015,78472,511,39,1739,122219,18115,0.023571625724537675
2020-09-22,2020-09-22,2145231,18630,508,0.0,119404,357,11,18515,56073,74588,612,16,654,122873,18122,0.028032226023617702
2020-09-23,2020-09-23,2162333,17102,559,0.0,119702,298,11,16965,49387,66352,689,69,1729,124602,16543,0.033790727195792784
2020-09-24,2020-09-24,2179586,17253,597,0.0,120002,300,15,17111,57040,74151,697,63,1631,126233,16656,0.03584293948126801
2020-09-25,2020-09-25,2196011,16425,551,0.0,120269,267,8,16278,44556,60834,676,64,1819,128052,15874,0.0347108479274285
2020-09-26,2020-09-26,2207339,11328,364,0.0,120323,54,1,11251,15184,26435,418,45,1378,129430,10964,0.03319956220357534
2020-09-27,2020-09-27,2216095,8756,224,0.0,120358,35,1,8701,14661,23362,271,45,1248,130678,8532,0.02625410220346929
2020-09-28,2020-09-28,2237509,21414,867,0.0,120639,281,15,21168,61674,82842,997,61,1733,132411,20547,0.04219594101328661
2020-09-29,2020-09-29,2257444,19935,716,0.0,120918,279,12,19784,58474,78258,831,68,1788,134199,19219,0.03725479993756179
2020-09-30,2020-09-30,2274815,17371,609,0.0,121189,271,5,17220,48867,66087,730,67,1721,135920,16762,0.03633217993079585
2020-10-01,2020-10-01,2291191,16376,679,0.0,121459,270,8,16198,59708,75906,809,62,1669,137589,15697,0.04325667324966554
2020-10-02,2020-10-02,2308301,17110,566,0.0,121723,264,5,16975,47522,64497,674,44,1900,139489,16544,0.034211798839458414
2020-10-03,2020-10-03,2320038,11737,408,0.0,121785,62,5,11678,16966,28644,480,61,1585,141074,11329,0.03601376997087122
2020-10-04,2020-10-04,2327761,7723,292,0.0,121808,23,1,7658,18873,26531,359,61,1687,142761,7431,0.03929484591575831
2020-10-05,2020-10-05,2349827,22066,750,0.0,122084,276,12,21836,69506,91342,918,20,746,143507,21316,0.0351848376806155
2020-10-06,2020-10-06,2371983,22156,736,0.0,122380,296,19,21957,65675,87632,878,55,2123,145630,21420,0.03436041083099907
2020-10-07,2020-10-07,2393208,21225,720,0.0,122727,347,14,21029,56459,77488,872,55,2014,147644,20505,0.03511338697878566
2020-10-08,2020-10-08,2412528,19320,831,0.0,123026,299,16,19052,67342,86394,989,102,2044,149688,18489,0.04494564335550868
2020-10-09,2020-10-09,2428663,16135,687,0.0,123323,297,12,15882,43868,59750,876,56,1987,151675,15448,0.04447177628171932
2020-10-10,2020-10-10,2439130,10467,411,0.0,123374,51,3,10332,12572,22904,513,58,1624,153299,10056,0.04087112171837709
2020-10-11,2020-10-11,2446218,7088,260,0.0,123402,28,2,7003,15569,22572,322,73,1318,154617,6828,0.038078500292911543
2020-10-12,2020-10-12,2460174,13956,593,0.0,123565,163,9,13748,45525,59273,741,80,1987,156604,13363,0.0443762628152361
2020-10-13,2020-10-13,2478655,18481,788,0.0,123852,287,11,18155,68958,87113,941,51,1811,158415,17693,0.0445373876674391
2020-10-14,2020-10-14,2498969,20314,892,0.0,124144,292,14,20031,63542,83573,1123,69,1923,160338,19422,0.04592729893934713
2020-10-15,2020-10-15,2517398,18429,940,0.0,124420,276,11,18097,68305,86402,1156,50,1697,162035,17489,0.05374807021556407
2020-10-16,2020-10-16,2534472,17074,862,0.0,124694,274,10,16758,57253,74011,1078,80,1797,163832,16212,0.05317049099432519
2020-10-17,2020-10-17,2544830,10358,540,0.0,124746,52,6,10195,18380,28575,655,78,1315,165147,9818,0.05500101853738032
2020-10-18,2020-10-18,2552008,7178,325,0.0,124769,23,2,7077,18190,25267,389,68,1366,166513,6853,0.04742448562673282
2020-10-19,2020-10-19,2572199,20191,1050,0.0,125046,277,12,19777,66445,86222,1297,95,2068,168581,19141,0.05485606812601222
2020-10-20,2020-10-20,2591679,19480,1054,0.0,125276,230,11,19055,68226,87281,1238,91,1840,170421,18426,0.05720178009334636
2020-10-21,2020-10-21,2608890,17211,1058,0.0,125511,235,12,16785,51914,68699,1242,114,1701,172122,16153,0.06549866897789884
2020-10-22,2020-10-22,2628679,19789,1376,0.0,125778,267,12,19333,67535,86868,1584,117,1770,173892,18413,0.07472981046000109
2020-10-23,2020-10-23,2648459,19780,1145,0.0,126041,263,12,19347,55134,74481,1361,88,1705,175597,18635,0.06144352025757982
2020-10-24,2020-10-24,2659983,11524,674,0.0,126097,56,2,11271,18362,29633,847,99,1361,176958,10850,0.062119815668202766
2020-10-25,2020-10-25,2666001,6018,332,0.0,126120,23,1,5877,18188,24065,398,104,1420,178378,5686,0.05838902567710166
2020-10-26,2020-10-26,2680630,14629,903,0.0,126370,250,16,14207,58072,72279,1103,86,1949,180327,13726,0.06578755646218855
2020-10-27,2020-10-27,2684604,3974,189,0.0,126476,106,6,3898,22196,26094,241,15,435,180762,3785,0.049933949801849405
